###################################################
#.................................................#
#...#.....#....#....#####..#...#..................#
#...##...##...#.#.....#....##..#..................#
#...#.#.#.#..#...#....#....#.#.#..................#
#...#..#..#..#####....#....#..##..................#
#...#.....#..#...#..#####..#...#..................#
#.................................................#
#..................#.....#..#####..#...#..#...#...#
#..................##...##..#......##..#..#...#...#
#..................#.#.#.#..###....#.#.#..#...#...#
#..................#..#..#..#......#..##..#...#...#
#..................#.....#..#####..#...#..#####...#
#.................................................#
#...#####..............#####..............#####...#
#...#...#..............#...#..............#...#...#
#...#...#..............#...#..............#...#...#
#...#...#..............#...#..............#...#...#
#...##.##..............##.##..............##.##...#
#.................................................#
#.................................................#
###################################################